############
#       P  #
#       ####
#          #
#######    #
#   X##    #
#    ##    #
#          #
#          #
#       #  #
############