############
#          #
#   P   ####
#          #
#######  X #
#  O ##    #
#    ##    #
#          #
#          #
# OX    #  #
############