############
#        O #
#   P   ####
#          #
#######    #
#  O ##    #
#    ##    #
#          #
# OP    XX #
# OX    #  #
############