############
#        O #
#   P   ####
#          #
#######  dddd #
#  O ##    #
#    ##    #
#          #
#       XX #
# OX    #  #
############