############
#          #
#   P   ####
#          #
#######    #
#  O ##    #
#    ##    #
#          #
#      X   #
#       #  #
############