############
#        O #
#   P   ####
#          #
####### H   #
#  O ##    #
#    ##    #
#          #
#       XX #
# OX    #  #
############