############
#          #
#          #
#X  X    X #
#  XPX     #
#   X      #
#          #
#  O ##    #
#    ##    #
#          #
#       XX #
# OX    #  #
############