############
#          #
#   X      #
#X  X    X #
# XXPXX     #
#   X      #
#   X      #
#  O ##    #
#    ##    #
#          #
#       XX #
# OX    #  #
############